0.0
32.0
0.0
10.0
16.0
5.0
1 1 1 1 1 1 1 1 1 1 1 1 1 1 1 1
0 0 0 0 0 0 0 2 2 0 0 0 0 0 0 0
3 3 3 3 0 0 0 0 0 0 0 0 0 0 0 0
4 0 0 0 0 0 0 0 0 4 0 0 0 0 0 0
5 5 5 5 5 5 5 5 5 5 5 5 5 5 5 5